5555555555555555555555555555
5000000000000000000000000005
5000000000000440000000000005
5000000040004554000040000005
5000004540004554000454000005
5011045540004554000455401105
5011004400004554000044001105
5011000000045555400000001105
5010000000004554000000000105
5010000004000440004000000105
5010044445400000045444400105
5110455555540000455555540115
5110455555540000455555540115
5010044445400000045444400105
5010000004000440004000000105
5010000000004554000000000105
5011000000045555400000001105
5011004400004554000044001105
5011045540004554000455401105
5000004540004554000454000005
5000000400004554000040000005
5000000000000440000000000005
5000000000000000000000000005
5000000000011111100000000005
5000000000019000100000000005
5000500000010000100000050005
5000550000010000100000550005
5555555555555555555555555555