5555555555555555555555555555
5000000000000000000000000005
5000000000000000000000000005
5444400000010000100000044445
5444400001111001111000044445
5440000011111001111100000445
5440000011111001111100000445
5000000111144004411110000005
5000000111144004411110000005
5000000014444114444100000005
5000000014444114444100000005
5440000111111111111110000445
5440000111111111111110000445
5444400001144114410000044445
5444400001144114410000044445
5222222001111111111002222225
5222222001111111111002222225
5000000000101010101000000005
5000000000101010101000000005
5000000001010101010000000005
5000000001010101010000000005
5050505000000000000005050505
5050505000000000000005050505
5101010008811111100000101015
5101010008819000100000101015
5505050050010000100500505055
5505050050010000100500505055
5555555555555555555555555555