5555555555555555555555555555
5000000440000000000440000005
5000000000000000000000000005
5000000000011001100000000005
5000000000011001100000000005
5000011001144444411001100005
5000011001144444411001100005
5440000550044224400550000445
5440000550044224400550000445
5000011001144444411001100005
5000011001144444411001100005
5001144444411001144444455005
5001144444411001144444455005
5550044224400550044224400555
5550044224400550044224400555
5001144444411001144444455005
5001144444411001144444455005
5000011001111111111001100005
5000011001111111111001100005
5440000550011221100550000445
5440000550011221100550000445
5000011115511111111111100005
5000011115500000011111100005
5001111110011111100111111005
5001111110019000100111111005
5111155000010000100001111115
5111155000010000100001111115
5555555555555555555555555555