5555555555555555555555555555
5000000000000001111110000005
5000000000000001111110000005
5441111111100000000110000005
5441111111100000000110000005
5440000001100110000000011115
5440000001100000000000011115
5442222222222001110222211555
5442222222222001110222211005
5444400000022001100555011445
5444455555522001100555011445
5114411111122222200221111445
5114411111122222200221111445
5444444445522444455224444445
5444444445522444455224444445
5222222002222111100220000445
5222222002222111100220000445
5110000000011555500222255445
5110000000011000000222255445
5001111000000000000000000445
5001111000000000000000000445
5001111005555000055111100005
5001111000000000055111100005
5551111000011111100110000005
5551111000019000100110000005
5111111000010000100111111115
5111111000010000100111111115
5555555555555555555555555555